30
53 86 56 66 76 42 42 96 36 39 20 78 64 59 35 49 87 45 99 65 31 11 55 79 27 53 89 83 47 57
73 58 70 25 89 98 86 12 54 10 39 96 96 12 10 67 16 52 50 68 90 91 67 49 39 97 74 47 45 100
35 54 48 67 66 27 71 45 51 53 89 95 86 56 59 47 92 64 26 56 80 45 14 16 94 88 26 53 25 92
53 41 10 72 50 69 94 16 24 15 17 48 75 43 33 81 54 48 94 33 88 58 59 37 91 35 19 61 93 77
44 94 93 35 13 74 32 33 11 74 68 35 56 90 65 46 32 62 13 95 83 94 30 81 44 28 94 42 96 47
54 45 23 80 55 76 25 12 44 51 51 25 78 61 95 96 50 98 59 93 60 88 12 34 24 98 18 93 65 93
28 80 67 100 11 39 60 32 64 21 14 66 39 12 93 74 75 12 78 69 78 22 12 43 64 86 26 75 15 52
81 78 84 70 17 72 22 14 23 83 87 41 59 18 68 32 39 61 91 93 65 15 80 12 67 48 76 22 94 90
13 98 90 23 62 35 49 12 92 14 22 25 89 100 87 61 93 77 29 66 88 35 17 83 13 12 28 29 41 73
80 19 50 78 26 60 38 10 46 67 61 36 44 56 78 81 69 99 44 25 38 13 59 93 75 93 54 87 57 45
74 62 57 88 11 19 70 85 38 67 50 98 63 99 98 50 51 39 41 79 83 91 20 13 93 57 85 43 44 46
94 70 26 12 64 95 74 79 15 53 71 14 78 89 29 72 60 36 87 96 40 49 26 50 81 100 69 31 96 96
50 50 46 76 15 100 24 26 72 100 47 66 25 84 50 97 79 36 30 96 42 84 11 43 96 74 51 98 61 64
38 83 89 46 88 58 59 63 41 25 19 83 98 26 41 59 82 39 28 45 53 72 22 69 95 37 75 84 100 32
46 34 82 88 52 23 51 62 98 99 58 83 51 61 90 34 86 92 16 59 76 79 91 50 40 54 13 40 40 81
10 86 67 23 23 45 92 59 37 52 68 22 77 92 90 71 16 27 30 88 98 94 88 32 49 51 13 42 44 88
90 66 18 82 51 68 46 31 93 80 90 18 26 33 54 47 61 62 91 66 72 89 88 91 60 37 92 59 55 18
77 37 24 65 62 10 62 25 73 16 24 51 42 81 21 61 76 54 56 48 41 15 85 49 63 45 49 51 22 95
79 31 15 99 87 37 18 81 54 17 99 65 33 10 76 26 78 15 80 34 65 91 10 36 19 42 89 36 17 72
18 22 94 88 71 17 62 97 18 37 85 90 68 19 32 50 52 80 61 93 27 48 72 16 72 73 81 15 40 21
17 33 75 13 79 90 94 57 21 89 28 94 70 92 94 20 85 79 43 34 99 83 82 50 93 98 95 66 35 87
36 83 94 97 48 44 100 76 33 57 43 34 76 38 45 34 80 19 41 29 74 67 20 34 25 28 79 10 35 39
89 55 11 96 63 94 67 10 49 71 28 53 76 31 64 60 66 83 46 15 97 57 72 16 85 45 90 20 92 94
58 59 87 67 73 40 22 84 53 22 70 50 30 28 76 21 56 99 43 19 20 46 67 73 23 90 61 64 13 43
91 69 57 58 55 52 23 79 11 50 66 61 61 75 90 98 35 56 77 55 26 67 23 71 15 85 32 35 65 50
94 57 49 91 79 70 53 85 51 71 36 94 76 25 20 57 99 78 45 84 28 66 13 11 69 83 97 80 49 45
86 80 39 70 60 28 28 86 67 76 78 43 85 84 24 94 39 79 21 19 62 79 21 93 54 97 27 70 38 64
68 11 96 51 30 62 64 41 26 51 44 79 70 52 45 64 78 93 92 78 22 85 83 18 44 30 40 61 83 85
57 21 86 24 34 67 98 71 48 72 13 68 71 38 29 43 31 51 74 93 25 85 61 86 98 39 38 22 10 73
15 17 80 22 49 66 21 20 77 79 59 76 47 11 31 59 39 22 32 31 92 64 31 22 88 24 24 93 20 50
